[Leetcode-字符串]

[-字串]
392

[-简单题]
551 557 606 657 680 
696 709 788 804 819 824 859 893 917 925 929 937 1071 1108 1189 1221 1309 1332 1370 
1374 1408 1417 1422 1436 1446 1455 1496 1507 1544 1556 1576 1592 1614 1624 1662 1668 1678 
1684 1694 1704 1736 1763 1768 1773 1790 1796 1805 1812 1816 1832 1844 1859 1876 1880 1897 
1903 1935 1941 1945 5701 5713

[-中等题]
3 5 6 8 12 17 22 43 49 71 91 93 151 165 227 316 385 443 468 522 537 539 553 556 583 609 647 
678 686 722 767 791 809 816 831 833 842 848 856 890 916 966 1003 1016 1023 1081 1138 1156 
1169 1170 1177 1233 1234 1247 1249 1268 1297 1311 1324 1328 1347 1358 1371 1404 1410 1419 
1432 1433 1451 1452 1456 1461 1487 1513 1525 1529 1540 1541 1545 1573 1604 1616 1638 1653 
1737 1759 1781 1807 1813 1839 1849 1850 1904 1910 1915 1946 5714

[-复杂题]
68 72 76 87 97 115 126 214 273 336 564 591 632 730 736 761 770 899 936 
1096 1106 1163 1316 1392 1449 1531 1542 1585 1745 1830 1948

[-字符串与哈希]
30

[-字符串与数字]
415(key=字符串相加)
65(key=带e字符串转浮点数)

[-字符串匹配]
28(key=实现strStr函数)
44(key=通配符匹配)

[-模拟题]
13 14 38 58 67 383 387 434 520

[-括号匹配]
20(key=有效括号) 32(key=最长匹配)

[-正则表达式]
10

[-子串问题]
459

[-反转]
344 345

[-回文]
125 336(key=回文)

