[Leetcode-贪心]

[-贪心]
1353
605(key=tricky简单题)

[-序列变化]
122

[-排序贪心]
455(key=经典贪心 star=5)

[-未分类]
860 874 944 1005 1046 1217 1221 1403 1518 1710 1716 1725 1736 1758 1784

55 134 316 376 402 406 435 452 621 649 659 714 738 763 767 
842 861 870 881 910 921 948 955 984 991 1007 1029 1053 1081 
1090 1094 1111 1247 1253 1276 1282 1288 1296 1338 1353 1386 
1400 1405 1414 1433 1497 1536 1540 1558 1567 1578 1589 1594 
1599 1605 1616 1620 1647 1648 1653 1657 1658 1663 1664 1673 1674 
1685 1686 1689 1702 1705 1717 1722 1727 1733 1737 1743 1749 1754 
1759 1764 1769 1774 1775 1785 1798 1801 1802 1806 1818

44 45 135 321 330 502 630 757 765 927 936 
995 1326 1354 1383 1505 1520 1568 
1585 1591 1632 1665 1681 1713 1793 5704


