[Leetcode-动态规划]

[-子序列]
53 121

[-斐波那契数列]
70 746 509 198 213(key=循环序列) 1770

[-树塔]
118 120 931(key=修正边界) 1289 1301(key=记忆路径)

[-计数DP]
62 64 63 91(key=多种情况处理) 576 790 935 1155 1641 1223 1220 552 1269 1420 1575 1639

[-记忆化搜索]
139 140 329

[-0/1背包]
416 494 1049 474 956

[-完全背包]
322 518 377 638 1449

[-概率DP]
688 808

[-树状DP]
96 823 1130 968

[-最优解问题]
279 368 646 650 801 813 1262 1537 309 714 983 123 188 256 265 1473 1235 1335
1187 514

[-博弈]
292 1025 464 486 877 1140 1406 1510

[-区间DP]
312 546 664 1478 1547 1563 1039 221 1139 1277 85

[-子序列/子字符串]
718 1035 1143 1458 674 300 673 354 1626 1092 1218 943

[-回文子序列]
516 5 647 730 131 132

[-字符串DP]
583 712 72 97 1312

[-正则表达式匹配]
678 10 44 639 14 741 1320 1463

[-DP优化]
837 1340 1696 1416 1425 1434 1444 1621 15 1125 1349 1655

[-轮廓线动态规划]
1659

[-未分类]
32 42 87 95 115 152 174 264 303 304 321 338 343 357 363 375
376 392 403 410 413 446 466 467 472 517 523 600 629 647
689 691 698 740 764 787 799 818 838 847 871 873 879 887 898
902 903 920 940 956 960 964 975 978 982 1000 1012 1024 1027
1043 1048 1074 1105 1147 1186 1191 1227 1240 1278 1314 1326 1339 
1359 1363 1367 1372 1373 1388 1397 1402 1405 1411 1423 1477 1483 
1504 1531 1546 1553 1569 1594 1595 1601 1611 1643 1654 1664 1671 
1687 1690 1691 1706 1728 1745 1751 1771


