[Leetcode-树]

[-遍历二叉树 简单题]
100 101 104 111 110 112 226 235 257 404 501 530 543 563 572 606 637 653 671

[-遍历二叉树 中等题]
94 95 96 98

[-生成二叉树]
108 617

[-简单题]
700 783 872 897 938 965 993 1022 1469

[-中等题]
102 103 105 106 107 113 114 116 117 129 144 145 156 173 199 222 230 236 250 255 285 298 333 337 366 426 429 437 449 450 508 510 513 515 536 538 545 549 582 623 652 654 655 662 663 666 669 684 687 701 742 776 814 
863 865 889 894 919 951 958 971 979 988 998 1008 1026 1038 1104 1110 1120 1123 1130 1145 1161 1245 1257 1261 1302 1305 1315 1325 1339 1367 1372 1379 1430 1443 1448 1457 1466 1484 1490 1530 1586 1600 1602 1609 1612 1628 1644 
1650 1660 1666 1676 1740

[-困难题]
99 124 272 297 428 431 685 834 968 987 1028 1516 1597 1719 1766 5670

