
[Leetcode-树]

[-遍历二叉树]
94 95 96 98 99 100 101 102 103 104 105 106 107 108 110 111 112 

[-生成二叉树]
113 114 116 117 124 129 144 145 156 173 199 222 226 230 235 236 

[-节点操作]
250 255 257 270 272 285 297 298 333 337 366 404 426 428 429 431 437 449 450 501 508 510 513 515 

[-路径问题]
530 536 538 543 545 549 559 563 572 582 589 590 606 617 623 637 652 653 654 655 662 663 666 669 

[-基本操作]
671 684 685 687 700 701 742 776 783 814 834 863 865 872 889 894 897 919 938 951 958 965 968 

971 979 987 988 993 998 1008 1022 1026 1028 1038 1104 1110 1120 1123 1130 1145 1161 1245 1257 1261 1302 

1305 1315 1325 1339 1367 1372 1379 1430 1443 1448 1457 1466 1469 1484 1490 1516 1530 1586 

1597 1600 1602 1609 1612 1628 1644 1650 1660 1666 1676 1719 1740 1766 5670

