[Leetcode-树]

[-遍历二叉树]
94(key=基础) 100 101 104(key=一行代码) 110(key=深度结合递归好题) 
112(key=分情况)
226(key=交换左右) 
530(key=中序遍历递增) 543(key=深度与直径)
563(key=算总值) 572(key=每一步检查) 606 
102(key=经典题队列实现) 637(key=队列实现) 
653(key=Hash) 671(key=记录次小值)

[-二叉搜索树中序遍历]
235(key=搜索有序树) 501(key=中序遍历递增) 98(key=中序遍历)

[-层次遍历]
111(key=层次遍历) 103

[-生成二叉树]
617 95(key=暴力遍历) 96(key=动态规划) 108(key=二分) 

[-中等题]
 105 106 107 113 114 116 117 129 144 145 156 173 199 222 230 236 250 255 285 298 333 337 
366 426 429 437 449 450 508 510 513 515 536 538 545 549 582 623 652 654 655 662 663 666 669 
684 687 701 742 776 814 
863 865 889 894 919 951 958 971 979 988 998 1008 1026 1038 1104 1110 1120 1123 1130 1145 1161 
1245 1257 1261 1302 1305 1315 1325 1339 1367 1372 1379 1430 1443 1448 1457 1466 1484 1490 1530 
1586 1600 1602 1609 1612 1628 1644 
1650 1660 1666 1676 1740

[-困难题]
99 124 272 297 428 431 685 834 968 987 1028 1516 1597 1719 1766 5670

